111111111111111111111
1C00010000000000000P1
101001000000000111111
101001000111110110C01
101101110000010010001
101C01000000010010001
101101011000010000001
10E100011C00000000001
111111111111111111111
